########################
#P...........#.........#
#....##........2...##..#
#..1........###........#
#........#........2....#
#....###.....1......P..#
#..P..............#....#
#......##..............#
#..1...........###....2#
#........#.............#
#....2.........1....2..#
#..##..............##..#
#.....2.....P..........#
########################
