########################
#P....2......#....2....#
#....##............##..#
#..2........###........#
#........#........2....#
#....###...............#
#..P..............#....#
#......##....P.........#
#..2...........###....2#
#........#.............#
#....2.........2.......#
#..##..............##..#
#.....2.....P.........2#
########################
